0 0 0 0 0 0 0
0 3 3 4 3 0 0
0 3 2 3 2 3 0
0 4 3 6 3 4 0
0 3 2 3 2 3 0
0 0 3 4 3 1 0
0 0 0 0 0 0 0