0 0 0 0 0 0 0
0 0 1 0 3 3 0
0 0 2 2 3 3 0
0 3 4 2 3 3 0
0 3 4 6 3 3 0
0 4 6 3 3 0 0
0 0 0 0 0 0 0